16
9
0 10 10 10 10 10 10 10 10 10 10 10 10 10 10 10
0 0 10 10 10 10 10 10 10 10 10 10 10 10 10 10
0 0 0 3 0 0 0 0 0 0 0 0 0 0 3 0
0 0 0 2 0 0 0 0 0 0 0 0 0 0 2 0
0 0 0 2 0 0 0 0 0 0 0 0 0 0 2 0
0 0 0 2 0 0 0 0 0 12 13 0 0 0 2 0
0 0 0 1 0 19 0 0 12 16 15 0 4 5 1 0
11 11 11 11 11 18 11 11 16 10 17 11 11 11 11 11
10 10 10 10 10 10 10 10 10 10 10 10 10 10 10 10