17
10
15 0 0 0 0 0 0 0 0 0 0 0 0 0 0 0 0 
15 0 0 0 0 0 0 0 0 0 0 0 0 0 0 0 0 
15 0 0 0 0 0 0 0 0 0 0 0 0 0 0 0 0 
15 0 0 0 0 0 0 0 0 0 0 0 0 0 0 0 0 
15 0 0 0 0 0 0 0 0 0 0 0 0 0 0 0 0 
15 11 11 11 11 11 11 11 11 11 0 0 0 0 0 0 0 
15 0 0 0 3 0 0 0 0 0 0 0 0 0 0 0 0 
15 0 0 0 2 0 0 0 0 0 0 0 0 0 0 0 0 
15 0 5 0 1 0 5 4 5 0 0 0 0 0 0 0 0 
17 11 11 11 11 11 11 11 11 11 0 0 0 0 0 0 0 
