16
9
13,12,12,12,12,12,12,12,12,12,12,12,12,12,12,14,
15,0,0,0,4,0,0,0,0,0,0,0,4,0,0,16,
15,0,0,0,3,0,0,0,0,0,0,0,3,0,0,16,
15,0,0,0,3,0,0,0,0,0,0,0,3,0,0,16,
15,0,0,0,3,0,0,0,0,0,0,0,3,0,0,16,
15,0,0,0,3,0,0,0,0,0,0,0,3,0,0,16,
15,0,0,0,3,0,0,0,20,0,0,0,3,0,0,16,
15,0,5,0,2,6,0,20,20,20,0,6,2,0,5,16,
18,12,12,12,12,12,12,12,12,12,12,12,12,12,12,17