16
9
25,25,26,1,1,1,24,25,25,26,0,0,0,24,25,25,
14,1,0,0,0,0,0,0,0,0,0,0,0,0,0,14,
14,0,10,0,0,8,0,0,0,8,0,0,0,0,0,14,
14,0,9,0,0,0,6,5,0,0,0,0,0,0,1,14,
14,14,14,14,14,14,14,14,14,14,14,0,0,0,6,14,
17,0,0,0,4,0,0,0,0,4,0,0,0,16,15,15,
19,0,0,8,3,0,0,0,8,3,0,0,16,20,14,14,
19,7,0,0,2,23,7,0,0,2,7,16,20,14,14,14,
21,15,15,15,15,22,15,15,15,15,15,20,14,14,14,14

