16
9
14,0,0,0,0,0,0,0,0,0,0,0,0,0,0,14,
14,0,0,8,10,0,0,0,0,0,0,0,0,0,0,14,
14,7,5,6,9,0,0,0,0,15,15,15,15,0,0,14,
14,15,15,15,15,15,15,15,15,14,0,0,0,0,0,14,
14,0,0,0,0,0,0,4,0,0,0,0,0,0,14,14,
14,0,0,10,8,0,0,3,0,0,0,15,15,15,14,14,
14,6,5,9,0,0,0,2,0,0,14,14,14,14,14,14,
14,15,15,15,15,15,15,15,15,15,14,14,14,14,14,14,
14,14,14,14,14,14,14,14,14,14,14,14,14,14,14,14

